Mahabharata
An Interactive Fiction by lizzard
Release 1 / Serial number 181217 / Inform 7 build 6M62 (I6/v6.33 lib 6/12N) SD

Palace of the Pandavas
By the front door of this marvelous palace, a gem-studded tree shines with the lights of emerald and beryl.  Veins of gold flash deeply like fire, and strands of pearl seem to outshine the moon.  The marble walls of the palace, and its golden columns, seem to reach to the heavens.

>e
Pandava Army Camp
The roar of a huge army echoes like the ocean at the full moon, in this battle-ready camp.  Amidst the bustle, the fully armed fighters are ready to rend the enemy ranks, weapons bristling.

>e
Battlefield of Kurukshetra
The once fertile plains are covered with a scene of death and destruction.  Armies still stand with banners flying proudly in the wind, and the scent of blood is never far away.

>e
Dusty Battlefield
The derangement of war swirls madly all around.  Dust dims the light, and wooden chariots splinter as the armies crash together.  You hear woeful shouts and cries and the bones of warriors break cruelly under the bright metal.

Bhima scowls ferociously at you.

>e
Bloody Battlefield
The blood-soaked earth is covered with fans and chains, broken spears and wheels, swords and rings, arrows and bells, dead flowers adorning fallen heads whose open mouths are filled with bright blood.

Sikhandin seeks to avenge herself on Bhishma.

>e
Raging Battlefield
Ten thousand arrows with fiery mouths, one hundred thousand swords and maces and axes, a million razor-edged wheels spinning, all fly through the air gleaming.  The battle rages all around.

Drona, the wise teacher, is in the midst of battle.

Dhristadyumna laughs horribly as he fights.

>e
You can't go that way.

>n
Battlefield Under the Mountain
Overhead, a high mountain seems to be floating in the sky, covered with cliffs and trees.  The roars of lions and tigers, leopards and wolves echo down like arrows of sound.  Iron-billed falcons and fiery-tongued snakes rain down from the mountain like meteors.

>n
Hill of Kurukshetra
This hill is still green and covered with flowers, though it overlooks a scene of grim death, smoke, and fire.  From the heavens you hear the delicate laughter of the Apsarasas and see the light glinting off the jewels on their breasts, as they welcome the dead heroes.

>n
Pavilion of the Kuru King
From the pavilion you can look out across the hill to the smoky, noisy battlefield of Kurukshetra.  Inside, all is cool and calm, with golden thrones fanned by palm leaves and yak-tail fans held by the lotus eyed, slender waisted attendants of the royal family.  Above the roof, storm clouds are gathered, dark and fierce as charging war elephants.

>up
Roof of the Kuru Pavilion
Dark clouds boil around you, thick with rain.  It almost seems that you could step up into the storm and ride the chariots of the thunder god.

>up
Cloud Chariot
Like coal-black horses with gleaming flanks, the clouds carry you across the stormy sky.  Below, the battle rages on.

>w
You can't go that way.

>s
Heavenly Overlook
A tall mountain of illusions rises above the clouds, filled with rakashas and apsarasas hooting as they watch the bloody battle of Kurukshetra.

>e
You can't go that way.

>s
Mount Kailasa
The mountain slopes up higher than you can climb.  Lotus pools fill the small valleys alive with birds and chattering monkeys.  Through the damp trees and vines, the scent of flowers rises in the gentle mist, and the battle seems far away.

>e
On a Tree Limb Over an Abyss
An ancient tree stretches out its limbs, festooned with flowering vines. Below, a crumbling cliff drops thousands of feet.  The leaves overhead form a pleasant, cool canopy, lulling you with their gentle rustling.

>w
Mount Kailasa
The mountain slopes up higher than you can climb.  Lotus pools fill the small valleys alive with birds and chattering monkeys.  Through the damp trees and vines, the scent of flowers rises in the gentle mist, and the battle seems far away.

>w
You can't go that way.

>n
Heavenly Overlook
A tall mountain of illusions rises above the clouds, filled with rakashas and apsarasas hooting as they watch the bloody battle of Kurukshetra.

>w
Thundercloud
Arrows of fire dart across this tall black cloud.  The chariots of the gods are close together here, and their clashing wheels strike fiery sparks.

>w
Chariot in the Clouds
Below on the battlefield, the rules of war are broken as men flee in horror, crushed by elephants.  The smell of fresh blood rises in the air.

>w
You can't go that way.

* * *

>n
Battlefield Under the Mountain
Overhead, a high mountain seems to be floating in the sky, covered with cliffs and trees.  The roars of lions and tigers, leopards and wolves echo down like arrows of sound.  Iron-billed falcons and fiery-tongued snakes rain down from the mountain like meteors.

>w
Mud on the Battlefield
Blood has run freely here.  The hooves of a thousand flame-colored horses have churned the dark earth and blood of heroes into a thick mud.

>n
River of Blood
The river runs red with blood, and even the low palm fronds that dip into its waters are crimson-dyed.  You feel a sense of great foreboding.  Anything could lurk in these swirling depths.

>s
Mud on the Battlefield
Blood has run freely here.  The hooves of a thousand flame-colored horses have churned the dark earth and blood of heroes into a thick mud.

>e
Battlefield Under the Mountain
Overhead, a high mountain seems to be floating in the sky, covered with cliffs and trees.  The roars of lions and tigers, leopards and wolves echo down like arrows of sound.  Iron-billed falcons and fiery-tongued snakes rain down from the mountain like meteors.

>n
Hill of Kurukshetra
This hill is still green and covered with flowers, though it overlooks a scene of grim death, smoke, and fire.  From the heavens you hear the delicate laughter of the Apsarasas and see the light glinting off the jewels on their breasts, as they welcome the dead heroes.

* * *

>up
Cloud Chariot
Like coal-black horses with gleaming flanks, the clouds carry you across the stormy sky.  Below, the battle rages on.

>s
Heavenly Overlook
A tall mountain of illusions rises above the clouds, filled with rakashas and apsarasas hooting as they watch the bloody battle of Kurukshetra.

* * *

>e
You can't go that way.

>e
You can't go that way.

* * *

>e
Raging Battlefield
Ten thousand arrows with fiery mouths, one hundred thousand swords and maces and axes, a million razor-edged wheels spinning, all fly through the air gleaming.  The battle rages all around.

Drona, the wise teacher, is in the midst of battle.

Dhristadyumna laughs horribly as he fights.

>n
Battlefield under the Mountain
Overhead, a high mountain seems to be floating in the sky, covered with cliffs and trees.  The roars of lions and tigers, leopards and wolves echo down like arrows of sound.  Iron-billed falcons and fiery-tongued snakes rain down from the mountain like meteors.

Kripa, the mighty archer, is here.

Ashvatthaman rides his black chariot across the field.

A white stallion snorts and paws a front hoof.

>n
Hill of Kurukshetra
This hill is still green and covered with flowers, though it overlooks a scene of grim death, smoke, and fire.  From the heavens you hear the delicate laughter of the Apsarasas and see the light glinting off the jewels on their breasts, as they welcome the dead heroes.

Bhishma is here sending a hail of arrows into battle.

>n
Pavilion of the Kuru King
From the pavilion you can look out across the hill to the smoky, noisy battlefield of Kurukshetra.  Inside, all is cool and calm, with golden thrones fanned by palm leaves and yak-tail fans held by the lotus eyed, slender waisted attendants of the royal family.  Above the roof, storm clouds are gathered, dark and fierce as charging war elephants.

Gandhari waits patiently, wearing her blindfold.

The blind Kuru king, Dhritarastra, waits for news.

Sanjaya, charioteer and war reporter, is here.

>n
You can't go that way.

>up
Roof of the Kuru Pavilion
Dark clouds boil around you, thick with rain.  It almost seems that you could step up into the storm and ride the chariots of the thunder god.

>up
Cloud Chariot
Like coal-black horses with gleaming flanks, the clouds carry you across the stormy sky.  Below, the battle rages on.

Lakshmi, the goddess of fortune, smiles upon you.

>w
You can't go that way.

>n
You can't go that way.

>e
You can't go that way.

>s
Heavenly Overlook
A tall mountain of illusions rises above the clouds, filled with rakashas and apsarasas hooting as they watch the bloody battle of Kurukshetra.

Agni, lord of fire, stares at you with yellow eyes.

Surya, the sun god, is driving his one-wheeled chariot.

Hidimbi, a beautiful but terrifying rakshasa, is here.

>w
Thundercloud
Arrows of fire dart across this tall black cloud.  The chariots of the gods are close together here, and their clashing wheels strike fiery sparks.

Indra looks down upon the raging battle.

Airavata, the lord of elephants, trumpets wildly.

>w
Chariot in the Clouds
Below on the battlefield, the rules of war are broken as men flee in horror, crushed by elephants.  The smell of fresh blood rises in the air.

Kali is dancing to the sound of terrible screams.

Yama, a terrifying green-skinned man grins at you.

>w
You can't go that way.

>s
You can't go that way.

>e
Thundercloud
Arrows of fire dart across this tall black cloud.  The chariots of the gods are close together here, and their clashing wheels strike fiery sparks.

Indra looks down upon the raging battle.

Airavata, the lord of elephants, trumpets wildly.

>d
You can't go that way.

>e
Heavenly Overlook
A tall mountain of illusions rises above the clouds, filled with rakashas and apsarasas hooting as they watch the bloody battle of Kurukshetra.

Agni, lord of fire, stares at you with yellow eyes.

Surya, the sun god, is driving his one-wheeled chariot.

Hidimbi, a beautiful but terrifying rakshasa, is here.

>s
Mount Kailasa
The mountain slopes up higher than you can climb.  Lotus pools fill the small valleys alive with birds and chattering monkeys.  Through the damp trees and vines, the scent of flowers rises in the gentle mist, and the battle seems far away.

Shiva is here, his serene brow adorned with a crescent moon.

>look at shiva
Shiva is sitting in a posture of serene meditation.  His brow bears a shining crescent moon and there are flowers in his hair.  His skin is a luminescent white, smeared with ashes.  Shiva is wearing a crescent moon, shining snake armlets, a garland of pearls, a writhing snake, a gleaming tiger skin and lively snake anklets and carries divine insight and a spear Pasupata.

* * *

>e
Raging Battlefield
Ten thousand arrows with fiery mouths, one hundred thousand swords and maces and axes, a million razor-edged wheels spinning, all fly through the air gleaming.  The battle rages all around.

Drona, the wise teacher, is in the midst of battle.

Dhristadyumna laughs horribly as he fights.

>s
Vulture-haunted Battlefield of Kurukshetra
Overhead, the sky is crowded with thunderclouds, the chariots of the gods who have come to watch the battle.  Vultures and ravens croak as they circle endlessly in the dusty sky.

>n
Raging Battlefield of Kurukshetra
Ten thousand arrows with fiery mouths, one hundred thousand swords and maces and axes, a million razor-edged wheels spinning, all fly through the air gleaming.  The battle rages all around.

* * *

>e
Dusty Battlefield
The derangement of war swirls madly all around.  Dust dims the light, and wooden chariots splinter as the armies crash together.  You hear woeful shouts and cries and the bones of warriors break cruelly under the bright metal.

Bhima scowls ferociously at you.

>s
Confusing Battlefield
The earth is strewn with bodies and bright weapons, red with blood. As if drunk on blood the world swirls with confusion and noise.

Nakula, a handsome, dark man with golden eyes is here.

Sahadeva, a fair-haired man with golden eyes is here.

>e
Corpse-strewn Battlefield
Severed hands clutch iron-bright swords like tigers" claws, scattered across the ground.  The headless stumps of dead men's bodies seem to be searching for their lives, stolen on this doomed, immortal battlefield.

Abhimanyu is still a boy, but he wears full armor into the battle.

>n
Bloody Battlefield
The blood-soaked earth is covered with fans and chains, broken spears and wheels, swords and rings, arrows and bells, dead flowers adorning fallen heads whose open mouths are filled with bright blood.

Sikhandin seeks to avenge herself on Bhishma.

>e
Raging Battlefield
Ten thousand arrows with fiery mouths, one hundred thousand swords and maces and axes, a million razor-edged wheels spinning, all fly through the air gleaming.  The battle rages all around.

Drona, the wise teacher, is in the midst of battle.

Dhristadyumna laughs horribly as he fights.

>look drona
Drona's arms are covered in white sandalwood paste; his matted silver hair tumbles about his face.  He aims his heron-feathered silver arrows with keen concentration.  The Pandus do not dare to kill him, since he is their beloved and respected teacher.

>l
Raging Battlefield
Ten thousand arrows with fiery mouths, one hundred thousand swords and maces and axes, a million razor-edged wheels spinning, all fly through the air gleaming.  The battle rages all around.

Drona, the wise teacher, is in the midst of battle.

Dhristadyumna laughs horribly as he fights.

>n
Battlefield under the Mountain
Overhead, a high mountain seems to be floating in the sky, covered with cliffs and trees.  The roars of lions and tigers, leopards and wolves echo down like arrows of sound.  Iron-billed falcons and fiery-tongued snakes rain down from the mountain like meteors.

Kripa, the mighty archer, is here.

Ashvatthaman rides his black chariot across the field.

A white stallion snorts and paws a front hoof.

>w
Mud on the Battlefield
Blood has run freely here.  The hooves of a thousand flame-colored horses have churned the dark earth and blood of heroes into a thick mud.

Krsna is driving Arjuna's chariot and giving him advice.

Arjuna bends his bow as he gazes into the battlefield.

This noble spotted horse is the color of flickering flames.

Karna stands tall in his resplendent armor.

>w
Archers' Battlefield
A hail of arrows descend upon the massed armies, as great heroes rush into battle, shouting the names of their families and the names of the enemies they have killed.

>s
Dusty Battlefield
The derangement of war swirls madly all around.  Dust dims the light, and wooden chariots splinter as the armies crash together.  You hear woeful shouts and cries and the bones of warriors break cruelly under the bright metal.

Bhima scowls ferociously at you.

>w
Battlefield of Kurukshetra
The once fertile plains are covered with a scene of death and destruction.  Armies still stand with banners flying proudly in the wind, and the scent of blood is never far away.

>w
Pandava Army Camp
The roar of a huge army echoes like the ocean at the full moon, in this battle-ready camp.  Amidst the bustle, the fully armed fighters are ready to rend the enemy ranks, weapons bristling.

>s
Vast Army Camp
The vast camp of the Pandavas is in a festive confusion, crawling with excited men.  It looks like the ocean at moonrise, with whirlpools of milling crowds, and chariots, elephants, and horses as the fish, the conches and drums as the roar of the waves, the spotless weapons as foam on the sea.

>n
Pandava Army Camp
The roar of a huge army echoes like the ocean at the full moon, in this battle-ready camp.  Amidst the bustle, the fully armed fighters are ready to rend the enemy ranks, weapons bristling.

>w
Palace of the Pandavas
By the front door of this marvelous palace, a gem-studded tree shines with the lights of emerald and beryl.  Veins of gold flash deeply like fire, and strands of pearl seem to outshine the moon.  The marble walls of the palace, and its golden columns, seem to reach to the heavens.

>s
South Hall of the Palace
The open windows of this cool marble palace are covered in thin networks of pure gold, twining like vines with leaves of emerald and blossoms of scarlet coral.  Lamps of softly shining gems illuminate the fine scarlet and gold carpets and the darkly polished, inlaid wooden furniture.

Yudisthira is here.

>look at yudisthira
Yudisthira has a noble, broad forehead and is dressed in a simple robe. His face is deeply lined with care and pain, but he smiles serenely at you. He almost seems to be meditating. He is wearing a golden moon and planets shield, and carrying unlucky dice and dharma.

>purloin dice
[Purloined.]

>i
You are carrying:
  unlucky dice

>examine dice
You see nothing special about unlucky dice.

>look at yudishtira
You can't see any such thing.

>look at Yudisthira
Yudisthira has a noble, broad forehead and is dressed in a simple robe. His face is deeply lined with care and pain, but he smiles serenely at you. He almost seems to be meditating. He is wearing a golden moon and planets shield, and carrying dharma.

>give dice to Yudisthria
You can't see any such thing.

>give dice to Yudisthira
Yudisthira doesn't seem interested.

>drop dice
Dropped.

>l
South Hall of the Palace
The open windows of this cool marble palace are covered in thin networks of pure gold, twining like vines with leaves of emerald and blossoms of scarlet coral.  Lamps of softly shining gems illuminate the fine scarlet and gold carpets and the darkly polished, inlaid wooden furniture.

Yudisthira is here.

You can also see unlucky dice here.

* * *

>s
Confusing Battlefield
The earth is strewn with bodies and bright weapons, red with blood. As if drunk on blood the world swirls with confusion and noise.

Nakula, a handsome, dark man with golden eyes is here.

Sahadeva, a fair-haired man with golden eyes is here.

>w
Echoing Battlefield of Kurukshetra
The field of battle echoes with the sounds of noble conch shells blown by the warrior lords.  Horns of brass, drums and gongs and cymbals accompany the trumpets of crazed elephants, and the clash of the bright swords of the heroes.

>e
Confusing Battlefield of Kurukshetra
The earth is strewn with bodies and bright weapons, red with blood. As if drunk on blood the world swirls with confusion and noise.

* * *

>e
Battlefield of Kurukshetra
The once fertile plains are covered with a scene of death and destruction.  Armies still stand with banners flying proudly in the wind, and the scent of blood is never far away.

>n
Shining Battlefield of Kurukshetra
The metal shields of the gathered armies are shining in the light as men rush towards each other like the waves of the sea rush to meet the shore. Nearby, war elephants clash like fighting storm clouds.

>n
You can't go that way.

>s
Battlefield of Kurukshetra
The once fertile plains are covered with a scene of death and destruction.  Armies still stand with banners flying proudly in the wind, and the scent of blood is never far away.

>w
Pandava Army Camp
The roar of a huge army echoes like the ocean at the full moon, in this battle-ready camp.  Amidst the bustle, the fully armed fighters are ready to rend the enemy ranks, weapons bristling.

>n
Pandava Army Tents
This level field has plentiful grass and kindling wood, a safe and auspicious location for a camp.  The ground gently slopes to the holy river Hiranvati, to the north.  Tents, carts, chariot axles, fodder, wagon surgeons, and brothel tents wave their colorful pennants in the breeze.

>n
Shores of the Holy River Hiranvati
The river Hiranvati flows easily, with water that is pure and clear of pebbles and mud.

>n
Striped Tent
This nicely furnished tent seems like a good place for a nap.  The air is cool, free from the dust of the battlefield.  Large pillows are spread with embroidered silken coverlets, and on a low table a lamp is burning.

Yudisthira is here.

>look at yudisthira
Yudisthira has a noble, broad forehead and is dressed in a simple robe. His face is deeply lined with care and pain, but he smiles serenely at you. He almost seems to be meditating.

* * *

>e
Pandava Army Camp
The roar of a huge army echoes like the ocean at the full moon, in this battle-ready camp.  Amidst the bustle, the fully armed fighters are ready to rend the enemy ranks, weapons bristling.

>n
Pandava Army Tents
This level field has plentiful grass and kindling wood, a safe and auspicious location for a camp.  The ground gently slopes to the holy river Hiranvati, to the north.  Tents, carts, chariot axles, fodder, wagon surgeons, and brothel tents wave their colorful pennants in the breeze.

>e
You can't go that way.

>n
Shores of the Holy River Hiranvati
The river Hiranvati flows easily, with water that is pure and clear of pebbles and mud.

Kunti gazes out over the camp, reciting a holy mantra.

>e
Noble Tent
This tent is furnished richly with thick, gold-embroidered carpets and low tables with flickering silver lamps.  Before a portable wooden altar, a young woman is meditating.

Draupadi waits for her husbands to return from battle.

>look at draupadi
Draupadi is married to the 5 Pandavas: Yudisthira, Bhima, Arjuna, Nakula and Sahadeva. She is renowned for her noble beauty and her flawless logic in matters of law and religion. She is wearing nothing, and carrying a knowledge of the law and wears an endless sari.

* * *

>n
Pandava Army Tents
This level field has plentiful grass and kindling wood, a safe and auspicious location for a camp.  The ground gently slopes to the holy river Hiranvati, to the north.  Tents, carts, chariot axles, fodder, wagon surgeons, and brothel tents wave their colorful pennants in the breeze.

>n
Shores of the Holy River Hiranvati
The river Hiranvati flows easily, with water that is pure and clear of pebbles and mud.

Kunti gazes out over the camp, reciting a holy mantra.

* * *

>e
Noble Tent
This tent is furnished richly with thick, gold-embroidered carpets and low tables with flickering silver lamps.  Before a portable wooden altar, a young woman is meditating.

Draupadi waits for her husbands to return from battle.

>look at draupadi
Draupadi is married to the 5 Pandavas: Yudisthira, Bhima, Arjuna, Nakula and Sahadeva. She is renowned for her noble beauty and her flawless logic in matters of law and religion. She is wearing an endless sari, and carrying amazing legal expertise.

* * *

>e
Noble Tent
This tent is furnished richly with thick, gold-embroidered carpets and low tables with flickering silver lamps.  Before a portable wooden altar, a young woman is meditating.

Draupadi waits for her husbands to return from battle.

>w
Shores of the Holy River Hiranvati
The river Hiranvati flows easily, with water that is pure and clear of pebbles and mud.

Kunti gazes out over the camp, reciting a holy mantra.

>s
Pandava Army Tents
This level field has plentiful grass and kindling wood, a safe and auspicious location for a camp.  The ground gently slopes to the holy river Hiranvati, to the north.  Tents, carts, chariot axles, fodder, wagon surgeons, and brothel tents wave their colorful pennants in the breeze.

* * *

>n
Shores of the Holy River Hiranvati
The river Hiranvati flows easily, with water that is pure and clear of pebbles and mud.

Kunti gazes out over the camp, reciting a holy mantra.

>n
Striped Tent
This nicely furnished tent seems like a good place for a nap.  The air is cool, free from the dust of the battlefield.  Large pillows are spread with embroidered silken coverlets, and on a low table a lamp is burning.

Yudisthira is here.

>e
You can't go that way.

>s
Shores of the Holy River Hiranvati
The river Hiranvati flows easily, with water that is pure and clear of pebbles and mud.

>e
Noble Tent
This tent is furnished richly with thick, gold-embroidered carpets and low tables with flickering silver lamps.  Before a portable wooden altar, a young woman is meditating.

>s
You can't go that way.

>w
Shores of the Holy River Hiranvati
The river Hiranvati flows easily, with water that is pure and clear of pebbles and mud.

>s
Pandava Army Tents
This level field has plentiful grass and kindling wood, a safe and auspicious location for a camp.  The ground gently slopes to the holy river Hiranvati, to the north.  Tents, carts, chariot axles, fodder, wagon surgeons, and brothel tents wave their colorful pennants in the breeze.

>s
Pandava Army Camp
The roar of a huge army echoes like the ocean at the full moon, in this battle-ready camp.  Amidst the bustle, the fully armed fighters are ready to rend the enemy ranks, weapons bristling.

* * *

>n
Striped Tent
This nicely furnished tent seems like a good place for a nap.  The air is cool, free from the dust of the battlefield.  Large pillows are spread with embroidered silken coverlets, and on a low table a lamp is burning.

Yudisthira is here.

>look at yudisthira
Yudisthira has a noble, broad forehead and is dressed in a simple robe. His face is deeply lined with care and pain, but he smiles serenely at you. He almost seems to be meditating. He is wearing a golden moon and planets shield and carrying unlucky dice and dharma.

>examine shield
A shield with a golden moon and planets

* * *

>look at yudisthira
Yudisthira has a noble, broad forehead and is dressed in a simple robe. His face is deeply lined with care and pain, but he smiles serenely at you. He almost seems to be meditating. He is wearing a golden moon and planets shield and carrying unlucky dice and dharma.

>examine yudisthira
Yudisthira has a noble, broad forehead and is dressed in a simple robe. His face is deeply lined with care and pain, but he smiles serenely at you. He almost seems to be meditating.

* * *

>look at yudisthira
Yudisthira has a noble, broad forehead and is dressed in a simple robe. His face is deeply lined with care and pain, but he smiles serenely at you. He almost seems to be meditating. He is wearing a golden moon and planets shield and carrying unlucky dice and dharma.

>look at shield
A shield with a golden moon and planets

* * *

>e
Pandava Army Camp
The roar of a huge army echoes like the ocean at the full moon, in this battle-ready camp.  Amidst the bustle, the fully armed fighters are ready to rend the enemy ranks, weapons bristling.

>s
Vast Army Camp
The vast camp of the Pandavas is in a festive confusion, crawling with excited men.  It looks like the ocean at moonrise, with whirlpools of milling crowds, and chariots, elephants, and horses as the fish, the conches and drums as the roar of the waves, the spotless weapons as foam on the sea.

* * *

>n
Pandava Army Camp
The roar of a huge army echoes like the ocean at the full moon, in this battle-ready camp.  Amidst the bustle, the fully armed fighters are ready to rend the enemy ranks, weapons bristling.

>n
Pandava Army Tents
This level field has plentiful grass and kindling wood, a safe and auspicious location for a camp.  The ground gently slopes to the holy river Hiranvati, to the north.  Tents, carts, chariot axles, fodder, wagon surgeons, and brothel tents wave their colorful pennants in the breeze.

>s
Pandava Army Camp
The roar of a huge army echoes like the ocean at the full moon, in this battle-ready camp.  Amidst the bustle, the fully armed fighters are ready to rend the enemy ranks, weapons bristling.

>e
Battlefield of Kurukshetra
The once fertile plains are covered with a scene of death and destruction.  Armies still stand with banners flying proudly in the wind, and the scent of blood is never far away.

>s
Echoing Battlefield of Kurukshetra
The field of battle echoes with the sounds of noble conch shells blown by the warrior lords.  Horns of brass, drums and gongs and cymbals accompany the trumpets of crazed elephants, and the clash of the bright swords of the heroes.

>e
Confusing Battlefield of Kurukshetra
The earth is strewn with bodies and bright weapons, red with blood. As if drunk on blood the world swirls with confusion and noise.

>e
Corpse-strewn Battlefield of Kurukshetra
Severed hands clutch iron-bright swords like tigers" claws, scattered across the ground.  The headless stumps of dead men's bodies seem to be searching for their lives, stolen on this doomed, immortal battlefield.

>e
Vulture-haunted Battlefield of Kurukshetra
Overhead, the sky is crowded with thunderclouds, the chariots of the gods who have come to watch the battle.  Vultures and ravens croak as they circle endlessly in the dusty sky.

>e
You can't go that way.

>n
Raging Battlefield of Kurukshetra
Ten thousand arrows with fiery mouths, one hundred thousand swords and maces and axes, a million razor-edged wheels spinning, all fly through the air gleaming.  The battle rages all around.

>w
Bloody Battlefield of Kurukshetra
The blood-soaked earth is covered with fans and chains, broken spears and wheels, swords and rings, arrows and bells, dead flowers adorning fallen heads whose open mouths are filled with bright blood.

>e
Raging Battlefield of Kurukshetra
Ten thousand arrows with fiery mouths, one hundred thousand swords and maces and axes, a million razor-edged wheels spinning, all fly through the air gleaming.  The battle rages all around.

>n
Battlefield Under the Mountain
Overhead, a high mountain seems to be floating in the sky, covered with cliffs and trees.  The roars of lions and tigers, leopards and wolves echo down like arrows of sound.  Iron-billed falcons and fiery-tongued snakes rain down from the mountain like meteors.

* * *

>w
Mud on the Battlefield
Blood has run freely here.  The hooves of a thousand flame-colored horses have churned the dark earth and blood of heroes into a thick mud.

>e
Battlefield Under the Mountain
Overhead, a high mountain seems to be floating in the sky, covered with cliffs and trees.  The roars of lions and tigers, leopards and wolves echo down like arrows of sound.  Iron-billed falcons and fiery-tongued snakes rain down from the mountain like meteors.

>w
Mud on the Battlefield
Blood has run freely here.  The hooves of a thousand flame-colored horses have churned the dark earth and blood of heroes into a thick mud.

* * *

>n
River of Blood
The river runs red with blood, and even the low palm fronds that dip into its waters are crimson-dyed.  You feel a sense of great foreboding.  Anything could lurk in these swirling depths.

>e
You can't go that way.

>s
Mud on the Battlefield
Blood has run freely here.  The hooves of a thousand flame-colored horses have churned the dark earth and blood of heroes into a thick mud.

* * *

>e
Pandava Army Camp
The roar of a huge army echoes like the ocean at the full moon, in this battle-ready camp.  Amidst the bustle, the fully armed fighters are ready to rend the enemy ranks, weapons bristling.

>w
Palace of the Pandavas
By the front door of this marvelous palace, a gem-studded tree shines with the lights of emerald and beryl.  Veins of gold flash deeply like fire, and strands of pearl seem to outshine the moon.  The marble walls of the palace, and its golden columns, seem to reach to the heavens.

>n
North Hall of the Palace
A thousand columns of gold rise to the heavens, surrounded with white marble and pearls.  Across the floor to the south, a stream of crystal flows and bubbles, filled with jeweled fish and glass water lilies.

>s
Palace of the Pandavas
By the front door of this marvelous palace, a gem-studded tree shines with the lights of emerald and beryl.  Veins of gold flash deeply like fire, and strands of pearl seem to outshine the moon.  The marble walls of the palace, and its golden columns, seem to reach to the heavens.

* * *

Mahabharata
An Interactive Fiction by lizzard
Release 1 / Serial number 181217 / Inform 7 build 6M62 (I6/v6.33 lib 6/12N) SD

Palace of the Pandavas
By the front door of this marvelous palace, a gem-studded tree shines with the lights of emerald and beryl.  Veins of gold flash deeply like fire, and strands of pearl seem to outshine the moon.  The marble walls of the palace, and its golden columns, seem to reach to the heavens.

>east
Pandava Army Camp
The roar of a huge army echoes like the ocean at the full moon, in this battle-ready camp.  Amidst the bustle, the fully armed fighters are ready to rend the enemy ranks, weapons bristling.

>north
Pandava Army Tents
This level field has plentiful grass and kindling wood, a safe and auspicious location for a camp.  The ground gently slopes to the holy river Hiranvati, to the north.  Tents, carts, chariot axles, fodder, wagon surgeons, and brothel tents wave their colorful pennants in the breeze.

>north
Shores of the Holy River Hiranvati
The river Hiranvati flows easily, with water that is pure and clear of pebbles and mud.

>north
Striped Tent
This nicely furnished tent seems like a good place for a nap.  The air is cool, free from the dust of the battlefield.  Large pillows are spread with embroidered silken coverlets, and on a low table a lamp is burning.

Yudisthira is here.

>look at yudisthira
Yudisthira has a noble, broad forehead and is dressed in a simple robe. His face is deeply lined with care and pain, but he smiles serenely at you. He almost seems to be meditating. He is wearing a golden moon and planets shield, and carrying unlucky dice and dharma.

* * *

Mahabharata
An Interactive Fiction by lizzard
Release 1 / Serial number 181217 / Inform 7 build 6M62 (I6/v6.33 lib 6/12N) SD

Palace of the Pandavas
By the front door of this marvelous palace, a gem-studded tree shines with the lights of emerald and beryl.  Veins of gold flash deeply like fire, and strands of pearl seem to outshine the moon.  The marble walls of the palace, and its golden columns, seem to reach to the heavens.

>n
North Hall of the Palace
A thousand columns of gold rise to the heavens, surrounded with white marble and pearls.  Across the floor to the south, a stream of crystal flows and bubbles, filled with jeweled fish and glass water lilies.

* * *

>s
Palace of the Pandavas
By the front door of this marvelous palace, a gem-studded tree shines with the lights of emerald and beryl.  Veins of gold flash deeply like fire, and strands of pearl seem to outshine the moon.  The marble walls of the palace, and its golden columns, seem to reach to the heavens.

>s
South Hall of the Palace
The open windows of this cool marble palace are covered in thin networks of pure gold, twining like vines with leaves of emerald and blossoms of scarlet coral.  Lamps of softly shining gems illuminate the fine scarlet and gold carpets and the darkly polished, inlaid wooden furniture.

>n
Palace of the Pandavas
By the front door of this marvelous palace, a gem-studded tree shines with the lights of emerald and beryl.  Veins of gold flash deeply like fire, and strands of pearl seem to outshine the moon.  The marble walls of the palace, and its golden columns, seem to reach to the heavens.

>w
Lotus Pond
Lofty trees shade the crystal clear pools of water, filled with fish and flowers.  Songbirds flit from tree to tree, warbling in the fragrant, breezy air.  Around the main lotus pond, the marble flagstones are cool even in the hot sun of midday.

>w
You can't go that way.

* * *

Mahabharata
An Interactive Fiction by lizzard
Release 1 / Serial number 181217 / Inform 7 build 6M62 (I6/v6.33 lib 6/12N) SD

Palace of the Pandavas
By the front door of this marvelous palace, a gem-studded tree shines with the lights of emerald and beryl.  Veins of gold flash deeply like fire, and strands of pearl seem to outshine the moon.  The marble walls of the palace, and its golden columns, seem to reach to the heavens.

>north
North Hall of the Palace
A thousand columns of gold rise to the heavens, surrounded with white marble and pearls.  Across the floor to the south, a stream of crystal flows and bubbles, filled with jeweled fish and glass water lilies.

Subhadra is here, combing her long dark hair.

>south
Palace of the Pandavas
By the front door of this marvelous palace, a gem-studded tree shines with the lights of emerald and beryl.  Veins of gold flash deeply like fire, and strands of pearl seem to outshine the moon.  The marble walls of the palace, and its golden columns, seem to reach to the heavens.

>go east
Pandava Army Camp
The roar of a huge army echoes like the ocean at the full moon, in this battle-ready camp.  Amidst the bustle, the fully armed fighters are ready to rend the enemy ranks, weapons bristling.

>north
Pandava Army Tents
This level field has plentiful grass and kindling wood, a safe and auspicious location for a camp.  The ground gently slopes to the holy river Hiranvati, to the north.  Tents, carts, chariot axles, fodder, wagon surgeons, and brothel tents wave their colorful pennants in the breeze.

>n
Shores of the Holy River Hiranvati
The river Hiranvati flows easily, with water that is pure and clear of pebbles and mud.

Kunti gazes out over the camp, reciting a holy mantra.

>look at kunti
This mature and beautiful woman is wearing a costly sari.  She is the mother of Yudisthira, Arjuna, and Bhima.  Karna is also her son.  She was the first wife of Pandu, but since he could not love her without dying, she used her powerful mantra to call down the gods as fathers to her children.

>south
Pandava Army Tents
This level field has plentiful grass and kindling wood, a safe and auspicious location for a camp.  The ground gently slopes to the holy river Hiranvati, to the north.  Tents, carts, chariot axles, fodder, wagon surgeons, and brothel tents wave their colorful pennants in the breeze.

>e
You can't go that way.

>s
Pandava Army Camp
The roar of a huge army echoes like the ocean at the full moon, in this battle-ready camp.  Amidst the bustle, the fully armed fighters are ready to rend the enemy ranks, weapons bristling.

* * *

>e
Dusty Battlefield
The derangement of war swirls madly all around.  Dust dims the light, and wooden chariots splinter as the armies crash together.  You hear woeful shouts and cries and the bones of warriors break cruelly under the bright metal.

Bhima scowls ferociously at you.

>n
Archers' Battlefield
A hail of arrows descend upon the massed armies, as great heroes rush into battle, shouting the names of their families and the names of the enemies they have killed.

>e
Mud on the Battlefield
Blood has run freely here.  The hooves of a thousand flame-colored horses have churned the dark earth and blood of heroes into a thick mud.

Krsna is driving Arjuna's chariot and giving him advice.

Arjuna bends his bow as he gazes into the battlefield.

This noble spotted horse is the color of flickering flames.

Karna stands tall in his resplendent armor.

>examine krsna
This noble prince is the sworn friend of Arjuna.  He is driving his chariot and fighting next to him in the battle.  Some think he is an avatar of the Divine Krishna, because of his amazing power and wisdom.

* * *

Mahabharata
An Interactive Fiction by lizzard
Release 1 / Serial number 181217 / Inform 7 build 6M62 (I6/v6.33 lib 6/12N) SD

Palace of the Pandavas
By the front door of this marvelous palace, a gem-studded tree shines with the lights of emerald and beryl.  Veins of gold flash deeply like fire, and strands of pearl seem to outshine the moon.  The marble walls of the palace, and its golden columns, seem to reach to the heavens.

>s
South Hall of the Palace
The open windows of this cool marble palace are covered in thin networks of pure gold, twining like vines with leaves of emerald and blossoms of scarlet coral.  Lamps of softly shining gems illuminate the fine scarlet and gold carpets and the darkly polished, inlaid wooden furniture.

* * *

Mahabharata
An Interactive Fiction by lizzard
Release 1 / Serial number 181217 / Inform 7 build 6M62 (I6/v6.33 lib 6/12N) SD

Palace of the Pandavas
By the front door of this marvelous palace, a gem-studded tree shines with the lights of emerald and beryl.  Veins of gold flash deeply like fire, and strands of pearl seem to outshine the moon.  The marble walls of the palace, and its golden columns, seem to reach to the heavens.

>south
South Hall of the Palace
The open windows of this cool marble palace are covered in thin networks of pure gold, twining like vines with leaves of emerald and blossoms of scarlet coral.  Lamps of softly shining gems illuminate the fine scarlet and gold carpets and the darkly polished, inlaid wooden furniture.

Yudisthira is here.

>n
Palace of the Pandavas
By the front door of this marvelous palace, a gem-studded tree shines with the lights of emerald and beryl.  Veins of gold flash deeply like fire, and strands of pearl seem to outshine the moon.  The marble walls of the palace, and its golden columns, seem to reach to the heavens.

>e
Pandava Army Camp
The roar of a huge army echoes like the ocean at the full moon, in this battle-ready camp.  Amidst the bustle, the fully armed fighters are ready to rend the enemy ranks, weapons bristling.

* * *

>south
South Hall of the Palace
The open windows of this cool marble palace are covered in thin networks of pure gold, twining like vines with leaves of emerald and blossoms of scarlet coral.  Lamps of softly shining gems illuminate the fine scarlet and gold carpets and the darkly polished, inlaid wooden furniture.

Yudisthira is here.

>north
Palace of the Pandavas
By the front door of this marvelous palace, a gem-studded tree shines with the lights of emerald and beryl.  Veins of gold flash deeply like fire, and strands of pearl seem to outshine the moon.  The marble walls of the palace, and its golden columns, seem to reach to the heavens.

>e
Pandava Army Camp
The roar of a huge army echoes like the ocean at the full moon, in this battle-ready camp.  Amidst the bustle, the fully armed fighters are ready to rend the enemy ranks, weapons bristling.

* * *

>e
Bloody Battlefield
The blood-soaked earth is covered with fans and chains, broken spears and wheels, swords and rings, arrows and bells, dead flowers adorning fallen heads whose open mouths are filled with bright blood.

Sikhandin seeks to avenge herself on Bhishma.

>e
Raging Battlefield
Ten thousand arrows with fiery mouths, one hundred thousand swords and maces and axes, a million razor-edged wheels spinning, all fly through the air gleaming.  The battle rages all around.

>e
You can't go that way.

>s
Vulture-haunted Battlefield
Overhead, the sky is crowded with thunderclouds, the chariots of the gods who have come to watch the battle.  Vultures and ravens croak as they circle endlessly in the dusty sky.

This tall proud man rides his bull elephant into war.

A vulture circles warily overhead.

>look man
You can't see any such thing.

>look at man
You can't see any such thing.

>look at person
You can't see any such thing.

* * *

Mahabharata
An Interactive Fiction by lizzard
Release 1 / Serial number 181217 / Inform 7 build 6M62 (I6/v6.33 lib 6/12N) SD

Palace of the Pandavas
By the front door of this marvelous palace, a gem-studded tree shines with the lights of emerald and beryl.  Veins of gold flash deeply like fire, and strands of pearl seem to outshine the moon.  The marble walls of the palace, and its golden columns, seem to reach to the heavens.

>w
Lotus Pond
Lofty trees shade the crystal clear pools of water, filled with fish and flowers.  Songbirds flit from tree to tree, warbling in the fragrant, breezy air.  Around the main lotus pond, the marble flagstones are cool even in the hot sun of midday.

You can see a crystal lotus flower and a pale lotus flower here.

>d
In the Pond
The crystal waters swirl around you, but somehow you are able to breathe. Lotus blossoms like gleaming moonlight rest softly in the waters as brightly colored fish nibble at your toes.

>exa
That's not a verb I recognise.

>exits
That's not a verb I recognise.

>up
Lotus Pond
Lofty trees shade the crystal clear pools of water, filled with fish and flowers.  Songbirds flit from tree to tree, warbling in the fragrant, breezy air.  Around the main lotus pond, the marble flagstones are cool even in the hot sun of midday.

* * *

>w
Lotus Pond
Lofty trees shade the crystal clear pools of water, filled with fish and flowers.  Songbirds flit from tree to tree, warbling in the fragrant, breezy air.  Around the main lotus pond, the marble flagstones are cool even in the hot sun of midday.

You can see a crystal lotus flower and a pale lotus flower here.

>s
You can't go that way.

>d
In the Pond
The crystal waters swirl around you, but somehow you are able to breathe. Lotus blossoms like gleaming moonlight rest softly in the waters as brightly colored fish nibble at your toes.

>up
Lotus Pond
Lofty trees shade the crystal clear pools of water, filled with fish and flowers.  Songbirds flit from tree to tree, warbling in the fragrant, breezy air.  Around the main lotus pond, the marble flagstones are cool even in the hot sun of midday.

>e
Palace of the Pandavas
By the front door of this marvelous palace, a gem-studded tree shines with the lights of emerald and beryl.  Veins of gold flash deeply like fire, and strands of pearl seem to outshine the moon.  The marble walls of the palace, and its golden columns, seem to reach to the heavens.

>s
South Hall of the Palace
The open windows of this cool marble palace are covered in thin networks of pure gold, twining like vines with leaves of emerald and blossoms of scarlet coral.  Lamps of softly shining gems illuminate the fine scarlet and gold carpets and the darkly polished, inlaid wooden furniture.

Yudisthira is here.

>n
Palace of the Pandavas
By the front door of this marvelous palace, a gem-studded tree shines with the lights of emerald and beryl.  Veins of gold flash deeply like fire, and strands of pearl seem to outshine the moon.  The marble walls of the palace, and its golden columns, seem to reach to the heavens.

>n
North Hall of the Palace
A thousand columns of gold rise to the heavens, surrounded with white marble and pearls.  Across the floor to the south, a stream of crystal flows and bubbles, filled with jeweled fish and glass water lilies.

Subhadra is here, combing her long dark hair.

>s
Palace of the Pandavas
By the front door of this marvelous palace, a gem-studded tree shines with the lights of emerald and beryl.  Veins of gold flash deeply like fire, and strands of pearl seem to outshine the moon.  The marble walls of the palace, and its golden columns, seem to reach to the heavens.

>e
Pandava Army Camp
The roar of a huge army echoes like the ocean at the full moon, in this battle-ready camp.  Amidst the bustle, the fully armed fighters are ready to rend the enemy ranks, weapons bristling.

* * *

>n
Shores of the Holy River Hiranvati
The river Hiranvati flows easily, with water that is pure and clear of pebbles and mud.

Kunti gazes out over the camp, reciting a holy mantra.

>s
Pandava Army Tents
This level field has plentiful grass and kindling wood, a safe and auspicious location for a camp.  The ground gently slopes to the holy river Hiranvati, to the north.  Tents, carts, chariot axles, fodder, wagon surgeons, and brothel tents wave their colorful pennants in the breeze.

* * *

>s
Pandava Army Camp
The roar of a huge army echoes like the ocean at the full moon, in this battle-ready camp.  Amidst the bustle, the fully armed fighters are ready to rend the enemy ranks, weapons bristling.

>s
Vast Army Camp
The vast camp of the Pandavas is in a festive confusion, crawling with excited men.  It looks like the ocean at moonrise, with whirlpools of milling crowds, and chariots, elephants, and horses as the fish, the conches and drums as the roar of the waves, the spotless weapons as foam on the sea.

* * *

>n
Pandava Army Camp
The roar of a huge army echoes like the ocean at the full moon, in this battle-ready camp.  Amidst the bustle, the fully armed fighters are ready to rend the enemy ranks, weapons bristling.

>e
Battlefield of Kurukshetra
The once fertile plains are covered with a scene of death and destruction.  Armies still stand with banners flying proudly in the wind, and the scent of blood is never far away.

>s
Echoing Battlefield
The field of battle echoes with the sounds of noble conch shells blown by the warrior lords.  Horns of brass, drums and gongs and cymbals accompany the trumpets of crazed elephants, and the clash of the bright swords of the heroes.

Ghatotkatcha is rushing madly into battle.

I beg your pardon?

>e
Confusing Battlefield
The earth is strewn with bodies and bright weapons, red with blood. As if drunk on blood the world swirls with confusion and noise.

A handsome, dark man with golden eyes is here.

A fair-haired man with golden eyes is here.

* * *

>w
Lotus Pond
Lofty trees shade the crystal clear pools of water, filled with fish and flowers.  Songbirds flit from tree to tree, warbling in the fragrant, breezy air.  Around the main lotus pond, the marble flagstones are cool even in the hot sun of midday.

You can see a crystal lotus flower and a pale lotus flower here.

>take flower
Which do you mean, the crystal lotus flower or the pale lotus flower?

>crystal
Taken.

>drop crystal
Dropped.